####################
#..................#
#........#......#..#
#####....###...@#..#
#~~~.....#......#..#
#~~~#....#.######..#
#~~~#....#~~~~~~~~~#
#~~~#....#~~~~~~#~~#
####################
