####################
#..................#
#........#......#..#
#####....###....#..#
#........#......#..#
#...#....#.######..#
#...#....#.........#
#...#....#......#..#
####################
