####################
#..................#
#........#......#..#
#####....###....#..#
#~~~.....#......#..#
#~~~#....#.######..#
#~~~#....#~~~~~~~~~#
#~~~#....#~~~~~~#~~#
####################
